11111111111
1C000000PE1
10110001101
10100000101
10001010001
10000000001
10001010001
10100000101
10110001101
1C000C00001
11111111111
