11111111111
1C0000000E1
10110001101
10100000101
10001010001
10000P00001
10001010001
10100000101
10110001101
1C0000000C1
11111111111
