11111111111
100000000E1
10110001101
1010C000101
10000100001
10001P10001
100000C0001
10100000101
1C110001101
100000C0001
11111111111
