111111111111111111111111111111111111111111111111111111111111
1PCCCCCC1CCCC00000000000000000000000000010000000100000000001
1C1C111C1C1C110000000000000000000000001010111110100000000001
1C1C1C1C1C1CC10000000000000000000000001010100000100000000001
1C111C1C1C11C10000000000000000000000001010101111100000000001
1CCCCC1C1CC1C10000000000000000000000001010101000100000000001
1C11111C1C11C10000000000000000000000001010101010100000000001
1C1CCCCCCCC1C10000000000000000000000001010101010100000000001
1C1111111111C10000000000000000000000001010101010100000000001
1CCC1CCCCCCCC10000000000000000000000001010101010100000000001
111111111111C10000000000000000000000001010101010100000000001
1CCCCCCCCCC1C10000000000000000000000001010101010100000000001
1C1111111111C10000000000000000000000001010101010100000000001
1CCCCCCCCCCCC10000000000000000000000001010101010100000000001
111111111111110000000000000000000000001010101010100000000001
100000000000000000000000000000000000001010101010101111111111
100000000000000000000000000000000000001010101010100000000001
100000000000000000000000000000000000001010101010111111111101
100000000000000000000000000000000000001010101010100000000001
100000000000000000000000000000000000001010101010101111111111
100000000000000000000000000000000000001010101010100000000001
100000000000000000000000000000000000001010101010111111111101
100000000000000000000000000000000000001010101010100000000001
100000000000000000000000000000000000001010101010101111111111
100000000000000000000000000000000000001010101010100000000001
100000000000000000000000000000000000001010101010111111111101
100000000000000000000000000000000000001010101010100000000001
100000000000000000000000000000000000001010101010101111111101
100000000000000000000000000000000000001010101010101000000001
100000000000000000000000000000000000001010101010101011111111
1000000000000000000000000000000000000010001000100010000000E1
111111111111111111111111111111111111111111111111111111111111